NO ./textures/taquillas.png
SO ./textures/greca.png
WE ./textures/famewall.png
EA ./textures/ordenagailu.png
F 14,60,255
C 15,15,25


111111111111111111111111111111
100000000000000000001000000001
101111011111011111101011111101
100001010000010000001010000001
111101011011110111101011011101
100001000010000100001000010001
101111111110111111111110111101
100000000010000000000010000001
111101111011111111101111011111
100001000010000000001000010001
101101011110111011111011010101
100001010000101000001010000001
111111010111101011101011111111
100000010001001000100010000001
101111110111101110111011111101
101000000000100010000000000101
101011111110101110111111101101
100010000010001N00010000001001
111110111010111011101011101111
100000100010000010001000100001
101111101111011110111110111101
100000000000000000000000000001
111111111111111111111111111111