NO ./textures/taquillas.png
SO ./textures/greca.png
WE ./textures/famewall.png
EA ./textures/ordenagailu.png
F 45a,54,70
C 20,20,20

111111111
100N00001
111111111
