NO ./textures/taquillas.png
SO ./textures/greca.png
WE ./textures/famewall.png
EA ./textures/ordenagailu.png
F 45,54,70
C 20,20,20

1111111111111111
1000000000000001
10000000000000N1
1000000000000001
1111111111111111
