NO ./textures/taquillas.png
SO ./textures/greca.png
WE ./textures/famewall.png
EA ./textures/ordenagailu.png
F 45,54,70
C 20,20,20

1111111111
1000000001
100  00001
100N 00001
1000000001
1111111111
